{
    "size": 48,
    "coordinates": {
        "B_01": { "x": 0, "y": 0 },
        "B_02": { "x": 1, "y": 0 },
        "B_03": { "x": 2, "y": 0 },
        "B_04": { "x": 3, "y": 0 },
        "B_05": { "x": 4, "y": 0 },
        "B_06": { "x": 5, "y": 0 },
        "B_07": { "x": 6, "y": 0 },
        "B_08": { "x": 7, "y": 0 },
        "B_09": { "x": 0, "y": 1 },
        "B_10": { "x": 1, "y": 1 },
        "B_11": { "x": 2, "y": 1 },
        "B_12": { "x": 3, "y": 1 },
        "B_13": { "x": 4, "y": 1 },
        "B_14": { "x": 5, "y": 1 },
        "B_15": { "x": 6, "y": 1 },
        "B_16": { "x": 7, "y": 1 },
        "B_17": { "x": 0, "y": 2 },
        "B_18": { "x": 1, "y": 2 },
        "B_19": { "x": 2, "y": 2 },
        "B_20": { "x": 3, "y": 2 },
        "B_21": { "x": 4, "y": 2 },
        "B_22": { "x": 5, "y": 2 },
        "B_23": { "x": 6, "y": 2 },
        "B_24": { "x": 7, "y": 2 },
        "B_25": { "x": 0, "y": 3 },
        "B_26": { "x": 1, "y": 3 },
        "B_27": { "x": 2, "y": 3 },
        "B_28": { "x": 3, "y": 3 },
        "B_29": { "x": 4, "y": 3 },
        "B_30": { "x": 5, "y": 3 },
        "B_31": { "x": 6, "y": 3 },
        "B_32": { "x": 7, "y": 3 }
    }
}